111111
1P11C1
101101
100001
1E0011
111111