1111111111111111111111111111111111
1P000CC000010C10000000CC00001000E1
101111110001C1101000001110001C1101
10CC010001110100100000111000101101
1011111100000001100001111000100001
1000011111010101100000111000CC0001
1000000000011101100000001111100001
100011111001C00C1000CC000000000001
100000000001C111100000000CCCC00001
1111111111111111111111111111111111