11111
11111
1C1C1
1CE01
1CCC1
1CCC1
1CCP1
11111