111111
1P11C1
10R101
100001
1E0011
111111