11111111111
1000C0100E1
100000C0001
11111P0C111
11111111111