11111
10001
111E1
101C1
10001
10001
101C1
101P1
11111