11111111111
100001100E1
100000C0001
11111P0C111
11111111111