1111111111
1P100E0011
1C00000011
1C01010011
1C01010C11
1111111111