11111
11111
1C1P1
10E01
10001
11111