11111111111
1000C0101E1
100000C0111
11111P0C111
10C00000001
11110000001
11111111111