11111
100P1
11101
101C1
10001
10001
101C1
100E1
11111