111111
1P11C1
101101
10E001
100011
111111