111111
1P11C1
101101
1000E1
100001
111111