1111111111111111111111111111111111
1P000CC0000100100000000C00001000E1
1011111100010110100000111000101101
10CC010001110100100000111000101101
1011111100000001100001111000100001
1000011111010101100000111000000001
1000000000011101100000001111100001
100011111001000C100000000000000001
1000000000010111100000000000000001
1111111111111111111111111111111111