11111111111
10100010011
11000000111
11100001111
1C000101011
1C0P10E0111
10000101001
100C0000001
11111111111