11111111111111111111111111111111111
1E000000000000000000000RR00000000R1
100000CCCC00R00000C0000R00000000001
10R000CCCC0000000000000000000000001
100000111111111111111111111000C0001
1000001000000000R000000RR0000000001
111111100000000000000000000C0000001
1P00CC0000000R00000000000000000R001
11111111111111111111111111111111111