111111111111111111
1E0000000000R00001
100000000000000R01
111111100000000001
1P00CC0000000R1111
111111111111111111